Localidades;Períodos;População ;População Masculina ;População Feminina ;Razão de Sexos ;População Urbana ;População Rural ;Grau de Urbanização (Em %);Cód. IBGE
Adamantina;2021;33869;16310;17559;92.89;32684;1185;96.5;3500105
Adolfo;2021;3436;1699;1737;97.81;3184;252;92.67;3500204
Aguaí;2021;35885;18021;17864;100.88;33151;2734;92.38;3500303
Águas da Prata;2021;7807;3834;3973;96.5;7215;592;92.42;3500402
Águas de Lindóia;2021;18438;8972;9466;94.78;18272;166;99.1;3500501
Águas de Santa Bárbara;2021;5957;2912;3045;95.63;4642;1315;77.93;3500550
Águas de São Pedro;2021;3144;1479;1665;88.83;3144;;100;3500600
Agudos;2021;36255;17869;18386;97.19;34955;1300;96.41;3500709
Alambari;2021;5856;2921;2935;99.52;4826;1030;82.41;3500758
Alfredo Marcondes;2021;3924;1999;1925;103.84;3571;353;91;3500808
Altair;2021;4052;2148;1904;112.82;3445;607;85.02;3500907
Altinópolis;2021;15547;7727;7820;98.81;14321;1226;92.11;3501004
Alto Alegre;2021;4006;2045;1961;104.28;3423;583;85.45;3501103
Alumínio;2021;18069;9067;9002;100.72;15155;2914;83.87;3501152
Álvares Florence;2021;3596;1818;1778;102.25;2663;933;74.05;3501202
Álvares Machado;2021;23828;11696;12132;96.41;21782;2046;91.41;3501301
Álvaro de Carvalho;2021;5079;3159;1920;164.53;3443;1636;67.79;3501400
Alvinlândia;2021;3190;1573;1617;97.28;2947;243;92.38;3501509
Americana;2021;235075;114935;120140;95.67;233977;1098;99.53;3501608
Américo Brasiliense;2021;40676;20312;20364;99.74;40368;308;99.24;3501707
Américo de Campos;2021;5730;2861;2869;99.72;5036;694;87.89;3501806
Amparo;2021;69861;34288;35573;96.39;59136;10725;84.65;3501905
Analândia;2021;4895;2497;2398;104.13;4122;773;84.21;3502002
Andradina;2021;56087;27456;28631;95.9;52935;3152;94.38;3502101
Angatuba;2021;24697;12392;12305;100.71;18550;6147;75.11;3502200
Anhembi;2021;6755;3437;3318;103.59;5342;1413;79.08;3502309
Anhumas;2021;3983;1981;2002;98.95;3513;470;88.2;3502408
Aparecida;2021;35744;17199;18545;92.74;35224;520;98.55;3502507
Aparecida d'Oeste;2021;4105;1987;2118;93.81;3581;524;87.24;3502606
Apiaí;2021;24711;12318;12393;99.39;20214;4497;81.8;3502705
Aramina;2021;5515;2749;2766;99.39;5320;195;96.46;3503000
Arandu;2021;6168;3099;3069;100.98;5127;1041;83.12;3503109
Arapeí;2021;2469;1232;1237;99.6;1924;545;77.93;3503158
Araraquara;2021;228792;110380;118412;93.22;222288;6504;97.16;3503208
Araras;2021;131931;64773;67158;96.45;125675;6256;95.26;3503307
Araçariguama;2021;21289;10761;10528;102.21;21289;;100;3502754
Araçatuba;2021;190921;91563;99358;92.15;187239;3682;98.07;3502804
Araçoiaba da Serra;2021;32846;16228;16618;97.65;22577;10269;68.74;3502903
ArcoÍris;2021;1806;900;906;99.34;1171;635;64.84;3503356
Arealva;2021;8223;4130;4093;100.9;6934;1289;84.32;3503406
Areias;2021;3860;1909;1951;97.85;2588;1272;67.05;3503505
Areiópolis;2021;10900;5577;5323;104.77;10134;766;92.97;3503604
Ariranha;2021;9378;4740;4638;102.2;8881;497;94.7;3503703
Artur Nogueira;2021;53224;26412;26812;98.51;48189;5035;90.54;3503802
Arujá;2021;90958;44839;46119;97.22;87623;3335;96.33;3503901
Aspásia;2021;1760;879;881;99.77;1327;433;75.4;3503950
Assis;2021;101825;49587;52238;94.93;97380;4445;95.63;3504008
Atibaia;2021;140589;68910;71679;96.14;131968;8621;93.87;3504107
Auriflama;2021;14478;7180;7298;98.38;13550;928;93.59;3504206
Avaí;2021;5314;2654;2660;99.77;3568;1746;67.14;3504305
Avanhandava;2021;12188;6673;5515;121;10305;1883;84.55;3504404
Avaré;2021;87854;43484;44370;98;84875;2979;96.61;3504503
Bady Bassitt;2021;16441;8164;8277;98.63;15440;1001;93.91;3504602
Balbinos;2021;3707;2980;727;409.9;1193;2514;32.18;3504701
Bálsamo;2021;8542;4157;4385;94.8;7971;571;93.32;3504800
Bananal;2021;10691;5270;5421;97.21;9071;1620;84.85;3504909
Barão de Antonina;2021;3407;1721;1686;102.08;2180;1227;63.99;3505005
Barbosa;2021;7345;3681;3664;100.46;6290;1055;85.64;3505104
Bariri;2021;34180;17033;17147;99.34;32979;1201;96.49;3505203
Barra Bonita;2021;34864;16979;17885;94.93;34224;640;98.16;3505302
Barra do Chapéu;2021;5561;2899;2662;108.9;1637;3924;29.44;3505351
Barra do Turvo;2021;7709;3977;3732;106.56;3645;4064;47.28;3505401
Barretos;2021;118419;57275;61144;93.67;114812;3607;96.95;3505500
Barrinha;2021;32658;16344;16314;100.18;32296;362;98.89;3505609
Barueri;2021;266236;129518;136718;94.73;266236;;100;3505708
Bastos;2021;20296;9910;10386;95.42;18040;2256;88.88;3505807
Batatais;2021;60502;29661;30841;96.17;53505;6997;88.44;3505906
Bauru;2021;365523;177109;188414;94;359409;6114;98.33;3506003
Bebedouro;2021;73969;35926;38043;94.44;71170;2799;96.22;3506102
Bento de Abreu;2021;2966;1499;1467;102.18;2842;124;95.82;3506201
Bernardino de Campos;2021;10793;5246;5547;94.57;9891;902;91.64;3506300
Bertioga;2021;64526;32002;32524;98.4;63952;574;99.11;3506359
Bilac;2021;7855;3866;3989;96.92;7424;431;94.51;3506409
Birigui;2021;122161;59350;62811;94.49;118968;3193;97.39;3506508
Biritiba Mirim;2021;32683;16394;16289;100.64;28554;4129;87.37;3506607
Boa Esperança do Sul;2021;14658;7316;7342;99.65;13504;1154;92.13;3506706
Bocaina;2021;12243;6072;6171;98.4;11456;787;93.57;3506805
Bofete;2021;11194;5622;5572;100.9;7137;4057;63.76;3506904
Boituva;2021;57987;29004;28983;100.07;54547;3440;94.07;3507001
Bom Jesus dos Perdões;2021;24625;12287;12338;99.59;22482;2143;91.3;3507100
Bom Sucesso de Itararé;2021;3894;1959;1935;101.24;2934;960;75.35;3507159
Borá;2021;811;421;390;107.95;632;179;77.93;3507209
Boracéia;2021;4798;2436;2362;103.13;4384;414;91.37;3507308
Borborema;2021;15370;7727;7643;101.1;14487;883;94.26;3507407
Borebi;2021;2602;1283;1319;97.27;2431;171;93.43;3507456
Botucatu;2021;142092;69051;73041;94.54;137360;4732;96.67;3507506
Bragança Paulista;2021;165241;81024;84217;96.21;162162;3079;98.14;3507605
Braúna;2021;5593;2805;2788;100.61;5208;385;93.12;3507704
Brejo Alegre;2021;2780;1412;1368;103.22;2398;382;86.26;3507753
Brodowski;2021;24132;11872;12260;96.84;23851;281;98.84;3507803
Brotas;2021;24039;11912;12127;98.23;20917;3122;87.01;3507902
Buri;2021;19819;10043;9776;102.73;16633;3186;83.92;3508009
Buritama;2021;16673;8297;8376;99.06;16016;657;96.06;3508108
Buritizal;2021;4323;2198;2125;103.44;3634;689;84.06;3508207
Cabrália Paulista;2021;4306;2174;2132;101.97;3761;545;87.34;3508306
Cabreúva;2021;50112;25163;24949;100.86;45093;5019;89.98;3508405
Cachoeira Paulista;2021;32381;15804;16577;95.34;27088;5293;83.65;3508603
Caconde;2021;18893;9384;9509;98.69;13630;5263;72.14;3508702
Cafelândia;2021;17286;8506;8780;96.88;15613;1673;90.32;3508801
Caiabu;2021;4104;2103;2001;105.1;3521;583;85.79;3508900
Caieiras;2021;101748;49841;51907;96.02;100032;1716;98.31;3509007
Caiuá;2021;5642;2911;2731;106.59;2161;3481;38.3;3509106
Cajamar;2021;78786;39214;39572;99.1;77888;898;98.86;3509205
Cajati;2021;29116;14647;14469;101.23;21623;7493;74.27;3509254
Cajobi;2021;10124;5142;4982;103.21;9623;501;95.05;3509304
Cajuru;2021;25850;12874;12976;99.21;23114;2736;89.42;3509403
Campina do Monte Alegre;2021;5832;2936;2896;101.38;5155;677;88.39;3509452
Campinas;2021;1181555;570167;611388;93.26;1161238;20317;98.28;3509502
Campo Limpo Paulista;2021;83530;40939;42591;96.12;83530;;100;3509601
Campos do Jordão;2021;50307;24452;25855;94.57;49993;314;99.38;3509700
Campos Novos Paulista;2021;4841;2475;2366;104.61;4022;819;83.08;3509809
Cananéia;2021;12379;6159;6220;99.02;10756;1623;86.89;3509908
Canas;2021;5120;2570;2550;100.78;4933;187;96.35;3509957
Cândido Mota;2021;30010;14685;15325;95.82;28544;1466;95.11;3510005
Cândido Rodrigues;2021;2672;1304;1368;95.32;2295;377;85.89;3510104
Canitar;2021;5051;2545;2506;101.56;4823;228;95.49;3510153
Capão Bonito;2021;46521;23098;23423;98.61;39678;6843;85.29;3510203
Capela do Alto;2021;20828;10656;10172;104.76;18136;2692;87.08;3510302
Capivari;2021;54686;27296;27390;99.66;53413;1273;97.67;3510401
Caraguatatuba;2021;117090;57431;59659;96.27;112783;4307;96.32;3510500
Carapicuíba;2021;396447;192549;203898;94.43;396447;;100;3510609
Cardoso;2021;11712;5729;5983;95.75;10782;930;92.06;3510708
Casa Branca;2021;29549;15476;14073;109.97;24506;5043;82.93;3510807
Cássia dos Coqueiros;2021;2486;1261;1225;102.94;1928;558;77.55;3510906
Castilho;2021;20937;10355;10582;97.85;15800;5137;75.46;3511003
Catanduva;2021;117414;56972;60442;94.26;116471;943;99.2;3511102
Catiguá;2021;7555;3812;3743;101.84;7039;516;93.17;3511201
Caçapava;2021;91646;45234;46412;97.46;78416;13230;85.56;3508504
Cedral;2021;8895;4412;4483;98.42;7404;1491;83.24;3511300
Cerqueira César;2021;19350;9519;9831;96.83;17886;1464;92.43;3511409
Cerquilho;2021;46932;23194;23738;97.71;44503;2429;94.82;3511508
Cesário Lange;2021;17360;8959;8401;106.64;11721;5639;67.52;3511607
Charqueada;2021;17075;8642;8433;102.48;15633;1442;91.55;3511706
Chavantes;2021;12229;6055;6174;98.07;11546;683;94.41;3557204
Clementina;2021;8413;4337;4076;106.4;8160;253;96.99;3511904
Colina;2021;17606;8655;8951;96.69;16806;800;95.46;3512001
Colômbia;2021;6048;3050;2998;101.73;4559;1489;75.38;3512100
Conchal;2021;27445;13790;13655;100.99;26574;871;96.83;3512209
Conchas;2021;17203;8583;8620;99.57;14752;2451;85.75;3512308
Cordeirópolis;2021;24615;12342;12273;100.56;22109;2506;89.82;3512407
Coroados;2021;5971;2961;3010;98.37;5144;827;86.15;3512506
Coronel Macedo;2021;4839;2459;2380;103.32;3986;853;82.37;3512605
Corumbataí;2021;3969;1992;1977;100.76;2512;1457;63.29;3512704
Cosmópolis;2021;72215;35858;36357;98.63;67068;5147;92.87;3512803
Cosmorama;2021;6976;3475;3501;99.26;5396;1580;77.35;3512902
Cotia;2021;251382;122984;128398;95.78;251382;;100;3513009
Cravinhos;2021;34637;17249;17388;99.2;34150;487;98.59;3513108
Cristais Paulista;2021;8494;4297;4197;102.38;7113;1381;83.74;3513207
Cruzália;2021;2105;1017;1088;93.47;1509;596;71.69;3513306
Cruzeiro;2021;80128;38908;41220;94.39;78323;1805;97.75;3513405
Cubatão;2021;130025;64526;65499;98.51;130025;;100;3513504
Cunha;2021;21660;10973;10687;102.68;13744;7916;63.45;3513603
Descalvado;2021;32516;15969;16547;96.51;30226;2290;92.96;3513702
Diadema;2021;405596;196182;209414;93.68;405596;;100;3513801
Dirce Reis;2021;1715;866;849;102;1425;290;83.09;3513850
Divinolândia;2021;10865;5349;5516;96.97;8256;2609;75.99;3513900
Dobrada;2021;8985;4607;4378;105.23;8785;200;97.77;3514007
Dois Córregos;2021;27151;13562;13589;99.8;26321;830;96.94;3514106
Dolcinópolis;2021;2033;1051;982;107.03;1908;125;93.85;3514205
Dourado;2021;8466;4250;4216;100.81;7766;700;91.73;3514304
Dracena;2021;45088;22165;22923;96.69;41908;3180;92.95;3514403
Duartina;2021;11941;5768;6173;93.44;11037;904;92.43;3514502
Dumont;2021;9659;4820;4839;99.61;9490;169;98.25;3514601
Echaporã;2021;6208;3042;3166;96.08;5155;1053;83.04;3514700
Eldorado;2021;15331;7734;7597;101.8;7545;7786;49.21;3514809
Elias Fausto;2021;17459;8973;8486;105.74;14772;2687;84.61;3514908
Elisiário;2021;3518;1824;1694;107.67;3287;231;93.43;3514924
Embaúba;2021;2406;1244;1162;107.06;2143;263;89.07;3514957
Embu das Artes;2021;273266;132810;140456;94.56;273266;;100;3515004
EmbuGuaçu;2021;68565;33894;34671;97.76;66736;1829;97.33;3515103
Emilianópolis;2021;3069;1534;1535;99.93;2706;363;88.17;3515129
Engenheiro Coelho;2021;20884;10835;10049;107.82;15965;4919;76.45;3515152
Espírito Santo do Pinhal;2021;42639;20833;21806;95.54;38983;3656;91.43;3515186
Espírito Santo do Turvo;2021;4850;2418;2432;99.42;4148;702;85.53;3515194
Estiva Gerbi;2021;11156;5555;5601;99.18;8898;2258;79.76;3557303
Estrela d'Oeste;2021;8083;4048;4035;100.32;7075;1008;87.53;3515202
Estrela do Norte;2021;2668;1357;1311;103.51;2326;342;87.18;3515301
Euclides da Cunha Paulista;2021;9549;4756;4793;99.23;6170;3379;64.61;3515350
Fartura;2021;15679;7564;8115;93.21;13124;2555;83.7;3515400
Fernando Prestes;2021;5568;2712;2856;94.96;5062;506;90.91;3515608
Fernandópolis;2021;66131;32060;34071;94.1;64105;2026;96.94;3515509
Fernão;2021;1656;830;826;100.48;1024;632;61.84;3515657
Ferraz de Vasconcelos;2021;195168;95326;99842;95.48;186411;8757;95.51;3515707
Flora Rica;2021;1575;780;795;98.11;1382;193;87.75;3515806
Floreal;2021;2842;1392;1450;96;2417;425;85.05;3515905
Flórida Paulista;2021;12060;6603;5457;121;9515;2545;78.9;3516002
Florínea;2021;2697;1303;1394;93.47;2475;222;91.77;3516101
Franca;2021;343801;168053;175748;95.62;337765;6036;98.24;3516200
Francisco Morato;2021;176346;87289;89057;98.01;175988;358;99.8;3516309
Franco da Rocha;2021;153903;78282;75621;103.52;141788;12115;92.13;3516408
Gabriel Monteiro;2021;2677;1340;1337;100.22;2391;286;89.32;3516507
Gália;2021;6537;3232;3305;97.79;5087;1450;77.82;3516606
Garça;2021;42385;20571;21814;94.3;39784;2601;93.86;3516705
Gastão Vidigal;2021;4811;2609;2202;118.48;4527;284;94.1;3516804
Gavião Peixoto;2021;4627;2369;2258;104.92;4158;469;89.86;3516853
General Salgado;2021;10632;5274;5358;98.43;9441;1191;88.8;3516903
Getulina;2021;10856;5890;4966;118.61;8888;1968;81.87;3517000
Glicério;2021;4762;2365;2397;98.66;3684;1078;77.36;3517109
Guaimbê;2021;5547;2740;2807;97.61;5074;473;91.47;3517307
Guaíra;2021;39154;19284;19870;97.05;37936;1218;96.89;3517406
Guaiçara;2021;12045;6028;6017;100.18;11245;800;93.36;3517208
Guapiara;2021;17832;9006;8826;102.04;7559;10273;42.39;3517604
Guapiaçu;2021;21060;10583;10477;101.01;19172;1888;91.04;3517505
Guará;2021;20907;10374;10533;98.49;20420;487;97.67;3517703
Guaraci;2021;11050;5599;5451;102.72;10295;755;93.17;3517901
Guarani d'Oeste;2021;1917;937;980;95.61;1715;202;89.46;3518008
Guarantã;2021;6485;3246;3239;100.22;5916;569;91.23;3518107
Guararapes;2021;32160;15761;16399;96.11;30277;1883;94.14;3518206
Guararema;2021;29736;14839;14897;99.61;25589;4147;86.05;3518305
Guaratinguetá;2021;118741;57102;61639;92.64;113258;5483;95.38;3518404
Guaraçaí;2021;8400;4132;4268;96.81;6926;1474;82.45;3517802
Guareí;2021;15844;9489;6355;149.32;9152;6692;57.76;3518503
Guariba;2021;39285;19684;19601;100.42;38682;603;98.47;3518602
Guarujá;2021;318774;155283;163491;94.98;318713;61;99.98;3518701
Guarulhos;2021;1361862;663550;698312;95.02;1361862;;100;3518800
Guatapará;2021;7482;3805;3677;103.48;6062;1420;81.02;3518859
Guzolândia;2021;5134;2590;2544;101.81;4592;542;89.44;3518909
Herculândia;2021;9310;4646;4664;99.61;8733;577;93.8;3519006
Holambra;2021;14711;7437;7274;102.24;12606;2105;85.69;3519055
Hortolândia;2021;233548;117291;116257;100.89;233548;;100;3519071
Iacanga;2021;11410;5832;5578;104.55;10134;1276;88.82;3519105
Iacri;2021;6255;3159;3096;102.03;5314;941;84.96;3519204
Iaras;2021;6943;4458;2485;179.4;3089;3854;44.49;3519253
Ibaté;2021;35044;17852;17192;103.84;33859;1185;96.62;3519303
Ibirá;2021;12132;5997;6135;97.75;11344;788;93.5;3519402
Ibirarema;2021;7570;3788;3782;100.16;7119;451;94.04;3519501
Ibitinga;2021;58860;28929;29931;96.65;56977;1883;96.8;3519600
Ibiúna;2021;76867;38714;38153;101.47;28507;48360;37.09;3519709
Icém;2021;8077;4098;3979;102.99;7008;1069;86.76;3519808
Iepê;2021;7943;3896;4047;96.27;7397;546;93.13;3519907
Igarapava;2021;29560;14599;14961;97.58;28246;1314;95.55;3520103
Igaratá;2021;9354;4746;4608;102.99;8055;1299;86.11;3520202
Igaraçu do Tietê;2021;24206;12005;12201;98.39;24067;139;99.43;3520004
Iguape;2021;29555;14668;14887;98.53;25946;3609;87.79;3520301
Ilha Comprida;2021;10410;5058;5352;94.51;10410;;100;3520426
Ilha Solteira;2021;25754;12421;13333;93.16;24167;1587;93.84;3520442
Ilhabela;2021;33821;17028;16793;101.4;33588;233;99.31;3520400
Indaiatuba;2021;245366;121414;123952;97.95;242899;2467;98.99;3520509
Indiana;2021;4771;2386;2385;100.04;4217;554;88.39;3520608
Indiaporã;2021;3847;1862;1985;93.8;3495;352;90.85;3520707
Inúbia Paulista;2021;3913;1947;1966;99.03;3557;356;90.9;3520806
Ipaussu;2021;14578;7312;7266;100.63;13729;849;94.18;3520905
Iperó;2021;34800;18393;16407;112.1;21474;13326;61.71;3521002
Ipeúna;2021;7711;3947;3764;104.86;7015;696;90.97;3521101
Ipiguá;2021;5286;2657;2629;101.07;3441;1845;65.1;3521150
Iporanga;2021;4424;2213;2211;100.09;2945;1479;66.57;3521200
Ipuã;2021;16001;8087;7914;102.19;15502;499;96.88;3521309
Iracemápolis;2021;23907;11907;12000;99.23;23489;418;98.25;3521408
Irapuã;2021;7767;4024;3743;107.51;7176;591;92.39;3521507
Irapuru;2021;7295;4234;3061;138.32;5158;2137;70.71;3521606
Itaberá;2021;17615;8831;8784;100.54;13505;4110;76.67;3521705
Itaí;2021;26725;14030;12695;110.52;20985;5740;78.52;3521804
Itajobi;2021;14602;7295;7307;99.84;12878;1724;88.19;3521903
Itaju;2021;3688;1906;1782;106.96;3012;676;81.67;3522000
Itanhaém;2021;99751;48020;51731;92.83;99021;730;99.27;3522109
Itaoca;2021;3187;1652;1535;107.62;1738;1449;54.53;3522158
Itapecerica da Serra;2021;171123;85313;85810;99.42;169705;1418;99.17;3522208
Itapetininga;2021;161509;80372;81137;99.06;148816;12693;92.14;3522307
Itapeva;2021;92123;45384;46739;97.1;84255;7868;91.46;3522406
Itapevi;2021;241150;118599;122551;96.78;241150;;100;3522505
Itapira;2021;71609;35266;36343;97.04;67192;4417;93.83;3522604
Itapirapuã Paulista;2021;4214;2139;2075;103.08;2175;2039;51.61;3522653
Itápolis;2021;41648;20534;21114;97.25;39150;2498;94;3522703
Itaporanga;2021;14710;7307;7403;98.7;12043;2667;81.87;3522802
Itapuí;2021;13913;6966;6947;100.27;13513;400;97.12;3522901
Itapura;2021;4965;2532;2433;104.07;3968;997;79.92;3523008
Itaquaquecetuba;2021;374997;184390;190607;96.74;374997;;100;3523107
Itararé;2021;49149;24071;25078;95.98;45600;3549;92.78;3523206
Itariri;2021;17442;8716;8726;99.89;12556;4886;71.99;3523305
Itatiba;2021;119084;58564;60520;96.77;104047;15037;87.37;3523404
Itatinga;2021;20752;10540;10212;103.21;19420;1332;93.58;3523503
Itirapina;2021;17284;10021;7263;137.97;16020;1264;92.69;3523602
Itirapuã;2021;6311;3182;3129;101.69;5470;841;86.67;3523701
Itobi;2021;7608;3887;3721;104.46;7176;432;94.32;3523800
Itu;2021;170938;84191;86747;97.05;162761;8177;95.22;3523909
Itupeva;2021;60255;30344;29911;101.45;56552;3703;93.85;3524006
Ituverava;2021;40333;19613;20720;94.66;37972;2361;94.15;3524105
Jaborandi;2021;6681;3351;3330;100.63;6351;330;95.06;3524204
Jaboticabal;2021;74352;36056;38296;94.15;73140;1212;98.37;3524303
Jacareí;2021;229163;111654;117509;95.02;225998;3165;98.62;3524402
Jaci;2021;7052;3563;3489;102.12;6467;585;91.7;3524501
Jacupiranga;2021;17237;8721;8516;102.41;9385;7852;54.45;3524600
Jaguariúna;2021;55477;27353;28124;97.26;54474;1003;98.19;3524709
Jales;2021;47242;22940;24302;94.4;44455;2787;94.1;3524808
Jambeiro;2021;6272;3193;3079;103.7;3003;3269;47.88;3524907
Jandira;2021;124940;61104;63836;95.72;124940;;100;3525003
Jardinópolis;2021;43258;21622;21636;99.94;42485;773;98.21;3525102
Jarinu;2021;30330;15088;15242;98.99;26338;3992;86.84;3525201
Jaú;2021;148613;72479;76134;95.2;145043;3570;97.6;3525300
Jeriquara;2021;3141;1602;1539;104.09;2746;395;87.42;3525409
Joanópolis;2021;12720;6359;6361;99.97;12720;;100;3525508
João Ramalho;2021;4404;2234;2170;102.95;3933;471;89.31;3525607
José Bonifácio;2021;36229;17991;18238;98.65;33493;2736;92.45;3525706
Júlio Mesquita;2021;4658;2263;2395;94.49;4447;211;95.47;3525805
Jumirim;2021;3343;1714;1629;105.22;2224;1119;66.53;3525854
Jundiaí;2021;409439;199858;209581;95.36;397835;11604;97.17;3525904
Junqueirópolis;2021;20174;10562;9612;109.88;17213;2961;85.32;3526001
Juquiá;2021;18856;9413;9443;99.68;12370;6486;65.6;3526100
Juquitiba;2021;30579;15334;15245;100.58;26445;4134;86.48;3526209
Lagoinha;2021;4821;2425;2396;101.21;3450;1371;71.56;3526308
Laranjal Paulista;2021;28042;13786;14256;96.7;25423;2619;90.66;3526407
Lavínia;2021;8476;5984;2492;240.13;4137;4339;48.81;3526506
Lavrinhas;2021;7218;3607;3611;99.89;6802;416;94.24;3526605
Leme;2021;101693;50701;50992;99.43;99889;1804;98.23;3526704
Lençóis Paulista;2021;66695;32947;33748;97.63;65524;1171;98.24;3526803
Limeira;2021;297662;145861;151801;96.09;290836;6826;97.71;3526902
Lindóia;2021;7789;3833;3956;96.89;7789;;100;3527009
Lins;2021;75318;36535;38783;94.2;74438;880;98.83;3527108
Lorena;2021;86952;41994;44958;93.41;84852;2100;97.58;3527207
Lourdes;2021;2183;1132;1051;107.71;1878;305;86.03;3527256
Louveira;2021;48965;24666;24299;101.51;47838;1127;97.7;3527306
Lucélia;2021;21092;11058;10034;110.21;18462;2630;87.53;3527405
Lucianópolis;2021;2264;1116;1148;97.21;1850;414;81.71;3527504
Luís Antônio;2021;14358;7383;6975;105.85;14166;192;98.66;3527603
Luiziânia;2021;5813;2999;2814;106.57;5509;304;94.77;3527702
Lupércio;2021;4428;2142;2286;93.7;4209;219;95.05;3527801
Lutécia;2021;2615;1294;1321;97.96;2202;413;84.21;3527900
Macatuba;2021;16981;8487;8494;99.92;16615;366;97.84;3528007
Macaubal;2021;7738;3873;3865;100.21;7031;707;90.86;3528106
Macedônia;2021;3562;1763;1799;98;2846;716;79.9;3528205
Magda;2021;3076;1559;1517;102.77;2638;438;85.76;3528304
Mairinque;2021;46569;23054;23515;98.04;37375;9194;80.26;3528403
Mairiporã;2021;100034;50155;49879;100.55;92576;7458;92.54;3528502
Manduri;2021;9562;4735;4827;98.09;8860;702;92.66;3528601
Marabá Paulista;2021;4942;3088;1854;166.56;2200;2742;44.52;3528700
Maracaí;2021;13526;6703;6823;98.24;12527;999;92.61;3528809
Marapoama;2021;2925;1485;1440;103.13;2645;280;90.43;3528858
Mariápolis;2021;3979;2029;1950;104.05;3428;551;86.15;3528908
Marília;2021;232599;112167;120432;93.14;222164;10435;95.51;3529005
Marinópolis;2021;2096;1058;1038;101.93;1733;363;82.68;3529104
Martinópolis;2021;25778;13298;12480;106.55;22473;3305;87.18;3529203
Matão;2021;80174;39486;40688;97.05;78703;1471;98.17;3529302
Mauá;2021;463338;226284;237054;95.46;463338;;100;3529401
Mendonça;2021;5069;2549;2520;101.15;4428;641;87.35;3529500
Meridiano;2021;3725;1795;1930;93.01;2709;1016;72.72;3529609
Mesópolis;2021;1893;941;952;98.84;1646;247;86.95;3529658
Miguelópolis;2021;21500;10666;10834;98.45;20554;946;95.6;3529708
Mineiros do Tietê;2021;12641;6264;6377;98.23;12076;565;95.53;3529807
Mira Estrela;2021;2949;1449;1500;96.6;1967;982;66.7;3530003
Miracatu;2021;19961;9902;10059;98.44;10833;9128;54.27;3529906
Mirandópolis;2021;28715;15563;13152;118.33;26282;2433;91.53;3530102
Mirante do Paranapanema;2021;17831;8930;8901;100.33;10500;7331;58.89;3530201
Mirassol;2021;58112;28497;29615;96.22;56644;1468;97.47;3530300
Mirassolândia;2021;4736;2399;2337;102.65;3851;885;81.31;3530409
Mococa;2021;66719;33050;33669;98.16;63533;3186;95.22;3530508
Mogi das Cruzes;2021;436883;212588;224295;94.78;405463;31420;92.81;3530607
Mogi Guaçu;2021;149071;73538;75533;97.36;143140;5931;96.02;3530706
Mogi Mirim;2021;90657;44400;46257;95.99;86932;3725;95.89;3530805
Mombuca;2021;3338;1685;1653;101.94;2969;369;88.95;3530904
Mongaguá;2021;55216;27287;27929;97.7;54975;241;99.56;3531100
Monte Alegre do Sul;2021;7792;3882;3910;99.28;4893;2899;62.8;3531209
Monte Alto;2021;48469;23772;24697;96.25;47016;1453;97;3531308
Monte Aprazível;2021;23561;11605;11956;97.06;21901;1660;92.95;3531407
Monte Azul Paulista;2021;18131;9001;9130;98.59;17314;817;95.49;3531506
Monte Castelo;2021;3985;1951;2034;95.92;3347;638;83.99;3531605
Monte Mor;2021;60555;30090;30465;98.77;57909;2646;95.63;3531803
Monteiro Lobato;2021;4491;2308;2183;105.73;2000;2491;44.53;3531704
Monções;2021;2173;1102;1071;102.89;1898;275;87.34;3531001
Morro Agudo;2021;32603;16550;16053;103.1;31848;755;97.68;3531902
Morungaba;2021;13359;6654;6705;99.24;12089;1270;90.49;3532009
Motuca;2021;4665;2338;2327;100.47;3756;909;80.51;3532058
Murutinga do Sul;2021;4283;2109;2174;97.01;2633;1650;61.48;3532108
Nantes;2021;3103;1544;1559;99.04;2976;127;95.91;3532157
Narandiba;2021;4888;2458;2430;101.15;4009;879;82.02;3532207
Natividade da Serra;2021;6703;3435;3268;105.11;2851;3852;42.53;3532306
Nazaré Paulista;2021;18611;9472;9139;103.64;18033;578;96.89;3532405
Neves Paulista;2021;8592;4236;4356;97.25;7917;675;92.14;3532504
Nhandeara;2021;10760;5252;5508;95.35;9067;1693;84.27;3532603
Nipoã;2021;5014;2615;2399;109;4558;456;90.91;3532702
Nova Aliança;2021;6487;3203;3284;97.53;5689;798;87.7;3532801
Nova Campina;2021;9787;4958;4829;102.67;7854;1933;80.25;3532827
Nova Canaã Paulista;2021;1921;968;953;101.57;988;933;51.43;3532843
Nova Castilho;2021;1180;574;606;94.72;954;226;80.85;3532868
Nova Europa;2021;10863;5351;5512;97.08;10328;535;95.08;3532900
Nova Granada;2021;21054;10569;10485;100.8;19727;1327;93.7;3533007
Nova Guataporanga;2021;2192;1091;1101;99.09;1976;216;90.15;3533106
Nova Independência;2021;3774;1868;1906;98.01;3226;548;85.48;3533205
Nova Luzitânia;2021;4083;2124;1959;108.42;3830;253;93.8;3533304
Nova Odessa;2021;58490;28905;29585;97.7;57537;953;98.37;3533403
Novais;2021;5575;2963;2612;113.44;5203;372;93.33;3533254
Novo Horizonte;2021;39124;19442;19682;98.78;36698;2426;93.8;3533502
Nuporanga;2021;7297;3628;3669;98.88;6973;324;95.56;3533601
Ocauçu;2021;4143;2091;2052;101.9;3600;543;86.89;3533700
Óleo;2021;2517;1244;1273;97.72;1825;692;72.51;3533809
Olímpia;2021;52670;25870;26800;96.53;50336;2334;95.57;3533908
Onda Verde;2021;4250;2166;2084;103.93;3639;611;85.62;3534005
Oriente;2021;6275;3052;3223;94.69;5970;305;95.14;3534104
Orindiúva;2021;6951;3505;3446;101.71;6489;462;93.35;3534203
Orlândia;2021;42436;20768;21668;95.85;41343;1093;97.42;3534302
Osasco;2021;682876;328742;354134;92.83;682876;;100;3534401
Oscar Bressane;2021;2508;1201;1307;91.89;2207;301;88;3534500
Osvaldo Cruz;2021;31256;15560;15696;99.13;28570;2686;91.41;3534609
Ourinhos;2021;111039;53845;57194;94.14;108171;2868;97.42;3534708
Ouro Verde;2021;8306;4086;4220;96.82;7834;472;94.32;3534807
Ouroeste;2021;9871;4876;4995;97.62;9210;661;93.3;3534757
Pacaembu;2021;13041;7592;5449;139.33;9609;3432;73.68;3534906
Palestina;2021;12220;6146;6074;101.19;10539;1681;86.24;3535002
Palmares Paulista;2021;13154;6956;6198;112.23;12775;379;97.12;3535101
Palmeira d'Oeste;2021;9092;4513;4579;98.56;7439;1653;81.82;3535200
Palmital;2021;21609;10514;11095;94.76;20467;1142;94.72;3535309
Panorama;2021;15253;7571;7682;98.56;14926;327;97.86;3535408
Paraguaçu Paulista;2021;44310;22163;22147;100.07;40155;4155;90.62;3535507
Paraibuna;2021;18304;9190;9114;100.83;5518;12786;30.15;3535606
Paraíso;2021;6293;3195;3098;103.13;5741;552;91.23;3535705
Paranapanema;2021;20151;10171;9980;101.91;17429;2722;86.49;3535804
Paranapuã;2021;3895;1980;1915;103.39;3577;318;91.84;3535903
Parapuã;2021;10473;5292;5181;102.14;9060;1413;86.51;3536000
Pardinho;2021;6467;3260;3207;101.65;5769;698;89.21;3536109
PariqueraAçu;2021;19311;9498;9813;96.79;13691;5620;70.9;3536208
Parisi;2021;2053;1036;1017;101.87;1724;329;83.97;3536257
Patrocínio Paulista;2021;14592;7339;7253;101.19;12472;2120;85.47;3536307
Paulicéia;2021;7213;3703;3510;105.5;6461;752;89.57;3536406
Paulínia;2021;106781;52694;54087;97.42;106682;99;99.91;3536505
Paulistânia;2021;1769;905;864;104.75;1394;375;78.8;3536570
Paulo de Faria;2021;8520;4260;4260;100;7823;697;91.82;3536604
Pederneiras;2021;45877;22846;23031;99.2;42665;3212;93;3536703
Pedra Bela;2021;5974;3093;2881;107.36;1737;4237;29.08;3536802
Pedranópolis;2021;2412;1237;1175;105.28;1546;866;64.1;3536901
Pedregulho;2021;16319;8224;8095;101.59;12218;4101;74.87;3537008
Pedreira;2021;46908;23155;23753;97.48;46514;394;99.16;3537107
Pedrinhas Paulista;2021;3015;1490;1525;97.7;2633;382;87.33;3537156
Pedro de Toledo;2021;11055;5504;5551;99.15;7833;3222;70.85;3537206
Penápolis;2021;60902;29617;31285;94.67;59055;1847;96.97;3537305
Pereira Barreto;2021;25411;12409;13002;95.44;23806;1605;93.68;3537404
Pereiras;2021;8507;4302;4205;102.31;5681;2826;66.78;3537503
Peruíbe;2021;66747;32364;34383;94.13;66364;383;99.43;3537602
Piacatu;2021;5936;2968;2968;100;5481;455;92.33;3537701
Piedade;2021;53656;27066;26590;101.79;25380;28276;47.3;3537800
Pilar do Sul;2021;28355;14295;14060;101.67;23720;4635;83.65;3537909
Pindamonhangaba;2021;164753;80825;83928;96.3;160348;4405;97.33;3538006
Pindorama;2021;16331;8271;8060;102.62;15458;873;94.65;3538105
Pinhalzinho;2021;14877;7395;7482;98.84;7507;7370;50.46;3538204
Piquerobi;2021;3532;1718;1814;94.71;2829;703;80.1;3538303
Piquete;2021;13621;6590;7031;93.73;12782;839;93.84;3538501
Piracaia;2021;26379;13033;13346;97.65;26379;;100;3538600
Piracicaba;2021;391464;191202;200262;95.48;384405;7059;98.2;3538709
Piraju;2021;28552;13824;14728;93.86;26358;2194;92.32;3538808
Pirajuí;2021;23274;12694;10580;119.98;19099;4175;82.06;3538907
Pirangi;2021;10825;5426;5399;100.5;9973;852;92.13;3539004
Pirapora do Bom Jesus;2021;19139;9424;9715;97;19139;;100;3539103
Pirapozinho;2021;27425;13378;14047;95.24;26326;1099;95.99;3539202
Pirassununga;2021;73921;36029;37892;95.08;69362;4559;93.83;3539301
Piratininga;2021;13305;6556;6749;97.14;11673;1632;87.73;3539400
Pitangueiras;2021;38852;19688;19164;102.73;37915;937;97.59;3539509
Planalto;2021;5221;2687;2534;106.04;4649;572;89.04;3539608
Platina;2021;3528;1817;1711;106.2;2928;600;82.99;3539707
Poá;2021;116289;56471;59818;94.4;114452;1837;98.42;3539806
Poloni;2021;5681;2794;2887;96.78;5057;624;89.02;3539905
Pompéia;2021;21384;10478;10906;96.08;20063;1321;93.82;3540002
Pongaí;2021;3340;1684;1656;101.69;2952;388;88.38;3540101
Pontal;2021;49889;26261;23628;111.14;49411;478;99.04;3540200
Pontalinda;2021;4515;2358;2157;109.32;3970;545;87.93;3540259
Pontes Gestal;2021;2530;1239;1291;95.97;2259;271;89.29;3540309
Populina;2021;3977;1979;1998;99.05;3346;631;84.13;3540408
Porangaba;2021;9380;4742;4638;102.24;4529;4851;48.28;3540507
Porto Feliz;2021;51907;25909;25998;99.66;45340;6567;87.35;3540606
Porto Ferreira;2021;54274;26764;27510;97.29;53300;974;98.21;3540705
Potim;2021;20815;11606;9209;126.03;15784;5031;75.83;3540754
Potirendaba;2021;16677;8443;8234;102.54;15368;1309;92.15;3540804
Pracinha;2021;2921;2098;823;254.92;1399;1522;47.89;3540853
Pradópolis;2021;21167;10716;10451;102.54;19757;1410;93.34;3540903
Praia Grande;2021;321008;154106;166902;92.33;321008;;100;3541000
Pratânia;2021;5210;2677;2533;105.68;4273;937;82.02;3541059
Presidente Alves;2021;4011;1986;2025;98.07;3545;466;88.38;3541109
Presidente Bernardes;2021;13713;6686;7027;95.15;11547;2166;84.2;3541208
Presidente Epitácio;2021;42484;20655;21829;94.62;39944;2540;94.02;3541307
Presidente Prudente;2021;221938;106693;115245;92.58;217411;4527;97.96;3541406
Presidente Venceslau;2021;37981;18934;19047;99.41;36880;1101;97.1;3541505
Promissão;2021;40001;19773;20228;97.75;34456;5545;86.14;3541604
Quadra;2021;3745;1941;1804;107.59;971;2774;25.93;3541653
Quatá;2021;14025;6975;7050;98.94;13328;697;95.03;3541703
Queiroz;2021;3319;1686;1633;103.25;2997;322;90.3;3541802
Queluz;2021;12735;6468;6267;103.21;10445;2290;82.02;3541901
Quintana;2021;6539;3221;3318;97.08;6050;489;92.52;3542008
Rafard;2021;9014;4448;4566;97.42;8140;874;90.3;3542107
Rancharia;2021;28855;14113;14742;95.73;26548;2307;92;3542206
Redenção da Serra;2021;3834;1973;1861;106.02;2821;1013;73.58;3542305
Regente Feijó;2021;19556;9642;9914;97.26;18391;1165;94.04;3542404
Reginópolis;2021;7204;4581;2623;174.65;4291;2913;59.56;3542503
Registro;2021;54270;26554;27716;95.81;48177;6093;88.77;3542602
Restinga;2021;7575;3782;3793;99.71;6270;1305;82.77;3542701
Ribeira;2021;3240;1646;1594;103.26;1511;1729;46.64;3542800
Ribeirão Bonito;2021;13033;6520;6513;100.11;12355;678;94.8;3542909
Ribeirão Branco;2021;17683;9050;8633;104.83;10637;7046;60.15;3543006
Ribeirão Corrente;2021;4698;2405;2293;104.88;3903;795;83.08;3543105
Ribeirão do Sul;2021;4351;2163;2188;98.86;3592;759;82.56;3543204
Ribeirão dos Índios;2021;2135;1050;1085;96.77;1899;236;88.95;3543238
Ribeirão Grande;2021;7515;3789;3726;101.69;2383;5132;31.71;3543253
Ribeirão Pires;2021;119339;58326;61013;95.6;119339;;100;3543303
Ribeirão Preto;2021;688894;331439;357455;92.72;686939;1955;99.72;3543402
Rifaina;2021;3470;1731;1739;99.54;3084;386;88.88;3543600
Rincão;2021;10506;5259;5247;100.23;8676;1830;82.58;3543709
Rinópolis;2021;9700;4868;4832;100.75;8921;779;91.97;3543808
Rio Claro;2021;202289;98367;103922;94.65;197912;4377;97.84;3543907
Rio das Pedras;2021;34768;17506;17262;101.41;34037;731;97.9;3544004
Rio Grande da Serra;2021;50313;24816;25497;97.33;50313;;100;3544103
Riolândia;2021;11501;6450;5051;127.7;9099;2402;79.11;3544202
Riversul;2021;5686;2786;2900;96.07;4307;1379;75.75;3543501
Rosana;2021;18320;8996;9324;96.48;17720;600;96.72;3544251
Roseira;2021;10723;5389;5334;101.03;10303;420;96.08;3544301
Rubiácea;2021;3138;1581;1557;101.54;1899;1239;60.52;3544400
Rubinéia;2021;2996;1466;1530;95.82;2639;357;88.08;3544509
Sabino;2021;5485;2723;2762;98.59;5022;463;91.56;3544608
Sagres;2021;2362;1165;1197;97.33;2005;357;84.89;3544707
Sales;2021;6082;3054;3028;100.86;5668;414;93.19;3544806
Sales Oliveira;2021;11580;5716;5864;97.48;10938;642;94.46;3544905
Salesópolis;2021;16945;8457;8488;99.63;11288;5657;66.62;3545001
Salmourão;2021;5138;2615;2523;103.65;4853;285;94.45;3545100
Saltinho;2021;7898;3902;3996;97.65;6630;1268;83.95;3545159
Salto;2021;116089;57226;58863;97.22;115273;816;99.3;3545209
Salto de Pirapora;2021;44522;22023;22499;97.88;35059;9463;78.75;3545308
Salto Grande;2021;9125;4497;4628;97.17;8421;704;92.28;3545407
Sandovalina;2021;4257;2152;2105;102.23;3444;813;80.9;3545506
Santa Adélia;2021;14929;7460;7469;99.88;14124;805;94.61;3545605
Santa Albertina;2021;5657;2835;2822;100.46;5059;598;89.43;3545704
Santa Bárbara d'Oeste;2021;189330;93482;95848;97.53;187844;1486;99.22;3545803
Santa Branca;2021;14212;7039;7173;98.13;12536;1676;88.21;3546009
Santa Clara d'Oeste;2021;1998;1024;974;105.13;1617;381;80.93;3546108
Santa Cruz da Conceição;2021;4372;2146;2226;96.41;3455;917;79.03;3546207
Santa Cruz da Esperança;2021;2086;1025;1061;96.61;1438;648;68.94;3546256
Santa Cruz das Palmeiras;2021;34031;17193;16838;102.11;33310;721;97.88;3546306
Santa Cruz do Rio Pardo;2021;46276;22592;23684;95.39;43496;2780;93.99;3546405
Santa Ernestina;2021;5527;2829;2698;104.86;5326;201;96.36;3546504
Santa Fé do Sul;2021;30897;14813;16084;92.1;29681;1216;96.06;3546603
Santa Gertrudes;2021;26572;13384;13188;101.49;26290;282;98.94;3546702
Santa Isabel;2021;55436;27521;27915;98.59;45141;10295;81.43;3546801
Santa Lúcia;2021;8590;4265;4325;98.61;8244;346;95.97;3546900
Santa Maria da Serra;2021;6208;3113;3095;100.58;5658;550;91.14;3547007
Santa Mercedes;2021;2814;1392;1422;97.89;2583;231;91.79;3547106
Santa Rita d'Oeste;2021;2389;1181;1208;97.76;1901;488;79.57;3547403
Santa Rita do Passa Quatro;2021;26355;12742;13613;93.6;24288;2067;92.16;3547502
Santa Rosa de Viterbo;2021;25732;12650;13082;96.7;24780;952;96.3;3547601
Santa Salete;2021;1438;726;712;101.97;1047;391;72.81;3547650
Santana da Ponte Pensa;2021;1497;753;744;101.21;1117;380;74.62;3547205
Santana de Parnaíba;2021;140616;69272;71344;97.1;140616;;100;3547304
Santo Anastácio;2021;20106;9770;10336;94.52;18976;1130;94.38;3547700
Santo André;2021;694681;333750;360931;92.47;694681;;100;3547809
Santo Antônio da Alegria;2021;6661;3400;3261;104.26;5026;1635;75.45;3547908
Santo Antônio de Posse;2021;23027;11525;11502;100.2;22070;957;95.84;3548005
Santo Antônio do Aracanguá;2021;8297;4180;4117;101.53;7268;1029;87.6;3548054
Santo Antônio do Jardim;2021;5823;2967;2856;103.89;3837;1986;65.89;3548104
Santo Antônio do Pinhal;2021;6643;3308;3335;99.19;4705;1938;70.83;3548203
Santo Expedito;2021;2986;1489;1497;99.47;2797;189;93.67;3548302
Santópolis do Aguapeí;2021;4698;2365;2333;101.37;4586;112;97.62;3548401
Santos;2021;429513;198398;231115;85.84;429191;322;99.93;3548500
São Bento do Sapucaí;2021;10539;5258;5281;99.56;5477;5062;51.97;3548609
São Bernardo do Campo;2021;815109;394025;421084;93.57;802052;13057;98.4;3548708
São Caetano do Sul;2021;151111;70267;80844;86.92;151111;;100;3548807
São Carlos;2021;244036;119495;124541;95.95;234262;9774;95.99;3548906
São Francisco;2021;2667;1323;1344;98.44;2201;466;82.53;3549003
São João da Boa Vista;2021;87537;42384;45153;93.87;85308;2229;97.45;3549102
São João das Duas Pontes;2021;2466;1211;1255;96.49;1902;564;77.13;3549201
São João de Iracema;2021;1853;926;927;99.89;1665;188;89.85;3549250
São João do Pau d'Alho;2021;1973;969;1004;96.51;1714;259;86.87;3549300
São Joaquim da Barra;2021;50553;24713;25840;95.64;49661;892;98.24;3549409
São José da Bela Vista;2021;8762;4455;4307;103.44;8009;753;91.41;3549508
São José do Barreiro;2021;4073;2026;2047;98.97;3250;823;79.79;3549607
São José do Rio Pardo;2021;53277;26120;27157;96.18;49257;4020;92.45;3549706
São José do Rio Preto;2021;450361;216998;233363;92.99;423039;27322;93.93;3549805
São José dos Campos;2021;716688;350251;366437;95.58;702108;14580;97.97;3549904
São Lourenço da Serra;2021;15721;7884;7837;100.6;14658;1063;93.24;3549953
São Luiz do Paraitinga;2021;10584;5356;5228;102.45;6351;4233;60.01;3550001
São Manuel;2021;39678;19361;20317;95.29;39162;516;98.7;3550100
São Miguel Arcanjo;2021;32115;16221;15894;102.06;24911;7204;77.57;3550209
São Paulo;2021;11914851;5675546;6239305;90.96;11807747;107104;99.1;3550308
São Pedro;2021;34408;16684;17724;94.13;30035;4373;87.29;3550407
São Pedro do Turvo;2021;7389;3745;3644;102.77;5796;1593;78.44;3550506
São Roque;2021;88032;43025;45007;95.6;85376;2656;96.98;3550605
São Sebastião;2021;88156;43638;44518;98.02;87163;993;98.87;3550704
São Sebastião da Grama;2021;11929;6070;5859;103.6;8543;3386;71.62;3550803
São Simão;2021;14891;7320;7571;96.68;13779;1112;92.53;3550902
São Vicente;2021;360262;173390;186872;92.79;359581;681;99.81;3551009
Sarapuí;2021;10206;5115;5091;100.47;8268;1938;81.01;3551108
Sarutaiá;2021;3652;1835;1817;100.99;3169;483;86.77;3551207
Sebastianópolis do Sul;2021;3304;1652;1652;100;2838;466;85.9;3551306
Serra Azul;2021;12381;7383;4998;147.72;8818;3563;71.22;3551405
Serra Negra;2021;27486;13292;14194;93.65;23946;3540;87.12;3551603
Serrana;2021;44870;22373;22497;99.45;44629;241;99.46;3551504
Sertãozinho;2021;123148;60978;62170;98.08;122595;553;99.55;3551702
Sete Barras;2021;12643;6375;6268;101.71;9315;3328;73.68;3551801
Severínia;2021;17263;8864;8399;105.54;16687;576;96.66;3551900
Silveiras;2021;6240;3130;3110;100.64;3384;2856;54.23;3552007
Socorro;2021;38896;19229;19667;97.77;27977;10919;71.93;3552106
Sorocaba;2021;663739;324558;339181;95.69;656984;6755;98.98;3552205
Sud Mennucci;2021;7728;3866;3862;100.1;6659;1069;86.17;3552304
Sumaré;2021;286462;141625;144837;97.78;283089;3373;98.82;3552403
Suzanápolis;2021;3990;2028;1962;103.36;2663;1327;66.74;3552551
Suzano;2021;293464;143602;149862;95.82;283133;10331;96.48;3552502
Tabapuã;2021;11918;5962;5956;100.1;11173;745;93.75;3552601
Tabatinga;2021;15996;8166;7830;104.29;14508;1488;90.7;3552700
Taboão da Serra;2021;287155;137912;149243;92.41;287155;;100;3552809
Taciba;2021;6081;3018;3063;98.53;5360;721;88.14;3552908
Taguaí;2021;13503;6705;6798;98.63;9673;3830;71.64;3553005
Taiaçu;2021;6048;3013;3035;99.28;5651;397;93.44;3553104
Taiúva;2021;6265;3586;2679;133.86;5893;372;94.06;3553203
Tambaú;2021;22846;11296;11550;97.8;20922;1924;91.58;3553302
Tanabi;2021;25147;12538;12609;99.44;23445;1702;93.23;3553401
Tapiraí;2021;7705;3850;3855;99.87;5816;1889;75.48;3553500
Tapiratiba;2021;12602;6184;6418;96.35;11357;1245;90.12;3553609
Taquaral;2021;2753;1382;1371;100.8;2664;89;96.77;3553658
Taquaritinga;2021;54531;26806;27725;96.69;52500;2031;96.28;3553708
Taquarituba;2021;23246;11564;11682;98.99;21250;1996;91.41;3553807
Taquarivaí;2021;5803;2894;2909;99.48;3390;2413;58.42;3553856
Tarabai;2021;7327;3629;3698;98.13;6898;429;94.14;3553906
Tarumã;2021;14951;7584;7367;102.95;14237;714;95.22;3553955
Tatuí;2021;121202;59697;61505;97.06;117899;3303;97.27;3554003
Taubaté;2021;309483;151515;157968;95.91;303179;6304;97.96;3554102
Tejupá;2021;4707;2387;2320;102.89;3647;1060;77.48;3554201
Teodoro Sampaio;2021;22495;11109;11386;97.57;18632;3863;82.83;3554300
Terra Roxa;2021;9170;4611;4559;101.14;8831;339;96.3;3554409
Tietê;2021;41405;20466;20939;97.74;37850;3555;91.41;3554508
Timburi;2021;2551;1305;1246;104.74;2003;548;78.52;3554607
Torre de Pedra;2021;2325;1208;1117;108.15;1668;657;71.74;3554656
Torrinha;2021;9736;4854;4882;99.43;8522;1214;87.53;3554706
Trabiju;2021;1716;847;869;97.47;1610;106;93.82;3554755
Tremembé;2021;46364;24064;22300;107.91;43230;3134;93.24;3554805
Três Fronteiras;2021;5550;2757;2793;98.71;4926;624;88.76;3554904
Tuiuti;2021;6597;3313;3284;100.88;3610;2987;54.72;3554953
Tupã;2021;62720;30242;32478;93.12;60204;2516;95.99;3555000
Tupi Paulista;2021;14877;7682;7195;106.77;11683;3194;78.53;3555109
Turiúba;2021;1905;975;930;104.84;1617;288;84.88;3555208
Turmalina;2021;1789;874;915;95.52;1368;421;76.47;3555307
Ubarana;2021;6126;3102;3024;102.58;5667;459;92.51;3555356
Ubatuba;2021;89782;44249;45533;97.18;87694;2088;97.67;3555406
Ubirajara;2021;4684;2407;2277;105.71;3458;1226;73.83;3555505
Uchoa;2021;9689;4781;4908;97.41;9090;599;93.82;3555604
União Paulista;2021;1751;905;846;106.97;1414;337;80.75;3555703
Urânia;2021;8584;4245;4339;97.83;7502;1082;87.4;3555802
Uru;2021;1203;609;594;102.53;1134;69;94.26;3555901
Urupês;2021;13181;6503;6678;97.38;12129;1052;92.02;3556008
Valentim Gentil;2021;12897;6442;6455;99.8;11989;908;92.96;3556107
Valinhos;2021;125800;61798;64002;96.56;120354;5446;95.67;3556206
Valparaíso;2021;24099;13102;10997;119.14;23484;615;97.45;3556305
Vargem;2021;10094;5110;4984;102.53;6469;3625;64.09;3556354
Vargem Grande do Sul;2021;41684;20576;21108;97.48;40150;1534;96.32;3556404
Vargem Grande Paulista;2021;53613;26524;27089;97.91;53613;;100;3556453
Várzea Paulista;2021;121482;60301;61181;98.56;121482;;100;3556503
Vera Cruz;2021;10506;5135;5371;95.61;9469;1037;90.13;3556602
Vinhedo;2021;78440;38678;39762;97.27;75975;2465;96.86;3556701
Viradouro;2021;18421;9224;9197;100.29;17882;539;97.07;3556800
Vista Alegre do Alto;2021;8091;4122;3969;103.85;7680;411;94.92;3556909
Vitória Brasil;2021;1761;890;871;102.18;1570;191;89.15;3556958
Votorantim;2021;120662;59700;60962;97.93;116060;4602;96.19;3557006
Votuporanga;2021;92193;44871;47322;94.82;89610;2583;97.2;3557105
Zacarias;2021;2574;1277;1297;98.46;2208;366;85.78;3557154
